slide_name,year,N,Y,var_delta,Y_cumul,N_cumul
13829$2000-050-10$US$SCAN$OR$001 -001,2000,3,6,3,6,3
13829$2000-050-11$US$SCAN$OR$001,2000,3,6,3,12,6
13829$2000-050-02$US$SCAN$OR$001,2000,1,5,4,17,7
13829$2000-050-03$US$SCAN$OR$001,2000,4,8,4,25,11
13829$2000-050-07$US$SCAN$OR$001,2000,4,8,4,33,15
13829$2000-050-12$US$SCAN$OR$001,2000,4,8,4,41,19
13829$2000-038-10$US$SCAN$OR$001,2000,0,6,6,47,19
13829$2000-038-7$US$SCAN$OR$001,2000,0,6,6,53,19
13829$2000-038-8$US$SCAN$OR$001,2000,0,6,6,59,19
13829$2000-038-9$US$SCAN$OR$001,2000,0,6,6,65,19
13829$2000-038-5$US$SCAN$OR$001,2000,0,8,8,73,19
13829$2000-038-6$US$SCAN$OR$001,2000,0,9,9,82,19
13829$2000-050-08$US$SCAN$OR$001,2000,0,9,9,91,19
13829$2000-050-09$US$SCAN$OR$001,2000,0,9,9,100,19
13829$2000-005-1$US$SCAN$OR$001,2000,0,10,10,110,19
13829$2000-050-04$US$SCAN$OR$001,2000,0,12,12,122,19
13829$2000-050-01$US$SCAN$OR$001,2000,0,15,15,137,19
13829$2000-050-06$US$SCAN$OR$001,2000,0,15,15,152,19
13829$2000-053-6$US$SCAN$OR$001,2000,0,15,15,167,19
13829$2000-005-2$US$SCAN$OR$001,2000,0,20,20,187,19
13829$2000-005-5$US$SCAN$OR$001 -003,2000,0,24,24,211,19
13829$2000-025-7$US$SCAN$OR$001,2000,0,28,28,239,19
13829$2001-019-1$US$SCAN$OR$001,2001,0,9,9,248,19
13829$2001-019-2$US$SCAN$OR$001,2001,0,9,9,257,19
13829$2001-019-3$US$SCAN$OR$001,2001,0,9,9,266,19
13829$2001-019-4$US$SCAN$OR$001,2001,0,9,9,275,19
13829$2001-019-6$US$SCAN$OR$001,2001,0,9,9,284,19
13829$2001-051-1$US$SCAN$OR$001,2001,0,9,9,293,19
13829$2001-019-5$US$SCAN$OR$001,2001,0,12,12,305,19
13829$2001-051-2$US$SCAN$OR$001,2001,0,12,12,317,19
13829$2001-051-3$US$SCAN$OR$001,2001,0,12,12,329,19
13829$2001-051-4$US$SCAN$OR$001,2001,0,12,12,341,19
13829$2002-060-1$US$SCAN$OR$001,2002,0,9,9,350,19
13829$2002-060-2$US$SCAN$OR$001,2002,0,9,9,359,19
13829$2002-007-4$US$SCAN$OR$001,2002,0,10,10,369,19
13829$2002-022-1$US$SCAN$OR$001,2002,0,16,16,385,19
13829$2002-022-2$US$SCAN$OR$001,2002,0,16,16,401,19
13829$2002-022-3$US$SCAN$OR$001,2002,0,16,16,417,19
13829$2003-033-1$US$SCAN$OR$001,2003,0,8,8,425,19
13829$2003-033-2$US$SCAN$OR$001,2003,0,8,8,433,19
13829$2003-033-3$US$SCAN$OR$001,2003,0,8,8,441,19
13829$2003-033-4$US$SCAN$OR$001,2003,0,8,8,449,19
13829$2003-033-5$US$SCAN$OR$001,2003,0,8,8,457,19
13829$2003-033-6$US$SCAN$OR$001 -001,2003,0,8,8,465,19
13829$2003-054-6$US$SCAN$OR$001 -001,2003,0,10,10,475,19
13829$2003-054-1$US$SCAN$OR$001 -001,2003,0,12,12,487,19
13829$2003-054-2$US$SCAN$OR$001 -001,2003,0,12,12,499,19
13829$2004-049-10$US$SCAN$OR$001,2004,0,8,8,507,19
13829$2004-049-3$US$SCAN$OR$001,2004,0,15,15,522,19
13829$2005-047-9$US$SCAN$OR$001,2005,0,6,6,528,19
13829$2005-047-13$US$SCAN$OR$001,2005,0,10,10,538,19
13829$2005-047-14$US$SCAN$OR$001,2005,0,10,10,548,19
13829$2006-023-3$US$SCAN$OR$001,2006,0,4,4,552,19
13829$2006-015-3$US$SCAN$OR$001,2006,0,6,6,558,19
13829$2007-014-5$US$SCAN$OR$001,2007,0,8,8,566,19
13829$2008-030-3$US$SCAN$OR$001,2008,0,6,6,572,19
13829$2008-030-5$US$SCAN$OR$001,2008,0,6,6,578,19
13829$2008-030-6$US$SCAN$OR$001,2008,0,6,6,584,19
13829$2008-027-1$US$SCAN$OR$001,2008,0,8,8,592,19
13829$2008-027-2$US$SCAN$OR$001,2008,0,8,8,600,19
13829$2009-031-1$US$SCAN$OR$001,2009,8,2,6,602,27
13829$2009-031-3$US$SCAN$OR$001,2009,8,2,6,604,35
13829$2009-031-6$US$SCAN$OR$001,2009,8,2,6,606,43
13829$2009-031-2$US$SCAN$OR$001,2009,9,2,7,608,52
13829$2009-031-4$US$SCAN$OR$001,2009,0,10,10,618,52
13829$2009-031-5$US$SCAN$OR$001,2009,0,10,10,628,52
13829$2010-015-6$US$SCAN$OR$001,2010,0,5,5,633,52
13829$2010-015-1$US$SCAN$OR$001,2010,0,10,10,643,52
13829$2010-015-2$US$SCAN$OR$001,2010,0,10,10,653,52
13829$2010-015-4$US$SCAN$OR$001,2010,0,10,10,663,52
13829$2011-039-5$US$SCAN$OR$001,2011,4,0,4,663,56
13829$2011-007-1$US$SCAN$OR$001,2011,0,5,5,668,56
13829$2011-009-1$US$SCAN$OR$001,2011,0,5,5,673,56
13829$2011-009-2$US$SCAN$OR$001,2011,0,5,5,678,56
13829$2011-039-1$US$SCAN$OR$001,2011,5,0,5,678,61
13829$2011-039-2$US$SCAN$OR$001,2011,5,0,5,678,66
13829$2011-039-3$US$SCAN$OR$001,2011,5,0,5,678,71
13829$2011-039-4$US$SCAN$OR$001,2011,5,0,5,678,76
13829$2011-039-6$US$SCAN$OR$001,2011,5,0,5,678,81
13829$2011-039-9$US$SCAN$OR$001,2011,5,0,5,678,86
13829$2012-030-3$US$SCAN$OR$001 -001,2012,0,4,4,682,86
13829$2012-022-11$US$SCAN$OR$001,2012,8,2,6,684,94
13829$2012-022-7$US$SCAN$OR$001,2012,8,2,6,686,102
13829$2012-022-8$US$SCAN$OR$001,2012,8,2,6,688,110
13829$2012-022-9$US$SCAN$OR$001,2012,8,2,6,690,118
13829$2012-029-1$US$SCAN$OR$001,2012,0,10,10,700,118
13829$2012-029-3$US$SCAN$OR$001,2012,0,10,10,710,118
13829$2013-047-1$US$SCAN$OR$001,2013,0,8,8,718,118
13829$2013-047-2$US$SCAN$OR$001,2013,0,8,8,726,118
13829$2013-047-4$US$SCAN$OR$001,2013,0,8,8,734,118
13829$2013-047-5$US$SCAN$OR$001,2013,0,8,8,742,118
13829$2013-047-6$US$SCAN$OR$001,2013,0,8,8,750,118
13829$2014-026-6$US$SCAN$OR$001,2014,0,5,5,755,118
13829$2014-047-1$US$SCAN$OR$001,2014,0,5,5,760,118
13829$2014-047-3$US$SCAN$OR$001,2014,0,5,5,765,118
13829$2014-056-04$US$SCAN$OR$001,2014,0,5,5,770,118
13829$2014-056-01$US$SCAN$OR$001,2014,0,10,10,780,118
13829$2014-056-02$US$SCAN$OR$001,2014,0,10,10,790,118
13829$2014-056-03$US$SCAN$OR$001,2014,0,10,10,800,118
13829$2014-056-05$US$SCAN$OR$001,2014,0,10,10,810,118
13829$2014-056-06$US$SCAN$OR$001,2014,0,10,10,820,118
13829$2014-031-3$US$SCAN$OR$001,2014,0,12,12,832,118
13829$2014-031-5$US$SCAN$OR$001,2014,0,12,12,844,118
13829$2014-046-1$US$SCAN$OR$001,2014,0,15,15,859,118
13829$2014-046-5$US$SCAN$OR$001,2014,0,15,15,874,118
13829$2015-015-1$US$SCAN$OR$001,2015,0,12,12,886,118
13829$2015-015-2$US$SCAN$OR$001,2015,0,12,12,898,118
13829$2015-015-3$US$SCAN$OR$001,2015,0,12,12,910,118
13829$2015-015-4$US$SCAN$OR$001,2015,0,12,12,922,118
13829$2015-015-5$US$SCAN$OR$001,2015,0,12,12,934,118
13829$2016-049-2$US$SCAN$OR$001,2016,4,6,2,940,122
13829$2016-049-3$US$SCAN$OR$001,2016,4,6,2,946,126
13829$2016-049-4$US$SCAN$OR$001,2016,4,6,2,952,130
13829$2016-049-5$US$SCAN$OR$001,2016,4,6,2,958,134
13829$2016-049-6$US$SCAN$OR$001,2016,4,6,2,964,138
13829$2016-0016-01$US$SCAN$OR$001,2016,0,6,6,970,138
13829$2016-0016-02$US$SCAN$OR$001,2016,0,6,6,976,138
13829$2016-0016-03$US$SCAN$OR$001,2016,0,6,6,982,138
13829$2016-0016-04$US$SCAN$OR$001,2016,0,6,6,988,138
13829$2016-0016-05$US$SCAN$OR$001 -001,2016,0,6,6,994,138
13829$2016-0016-06$US$SCAN$OR$001,2016,0,6,6,1000,138
13829$2016-017-1$US$SCAN$OR$001,2016,0,6,6,1006,138
13829$2016-017-2$US$SCAN$OR$001,2016,0,6,6,1012,138
13829$2016-017-3$US$SCAN$OR$001,2016,0,6,6,1018,138
13829$2016-017-4$US$SCAN$OR$001,2016,0,6,6,1024,138
13829$2016-017-5$US$SCAN$OR$001,2016,0,6,6,1030,138
13829$2016-049-1$US$SCAN$OR$001,2016,0,10,10,1040,138
13829$2017-044-1$US$SCAN$OR$001,2017,3,3,0,1043,141
13829$2017-044-2$US$SCAN$OR$001,2017,3,3,0,1046,144
13829$2017-044-3$US$SCAN$OR$001,2017,3,3,0,1049,147
13829$2017-044-4$US$SCAN$OR$001,2017,3,3,0,1052,150
13829$2017-044-6$US$SCAN$OR$001,2017,3,3,0,1055,153
13829$2017-044-5$US$SCAN$OR$001,2017,0,6,6,1061,153
13829$2017-042-6$US$SCAN$OR$001,2017,0,8,8,1069,153
13829$2018-016-5$US$SCAN$OR$001,2018,6,2,4,1071,159
13829$2018-016-6$US$SCAN$OR$001,2018,6,2,4,1073,165
13829$2018-016-1$US$SCAN$OR$001,2018,9,3,6,1076,174
13829$2018-016-2$US$SCAN$OR$001,2018,9,3,6,1079,183
13829$2018-016-3$US$SCAN$OR$001,2018,9,3,6,1082,192
13829$2018-016-4$US$SCAN$OR$001,2018,9,3,6,1085,201
13829$2019-018-6$US$SCAN$OR$001,2019,3,0,3,1085,204
13829$2019-018-1$US$SCAN$OR$001,2019,4,0,4,1085,208
13829$2019-018-2$US$SCAN$OR$001,2019,4,0,4,1085,212
13829$2019-018-3$US$SCAN$OR$001,2019,4,0,4,1085,216
13829$2019-018-4$US$SCAN$OR$001,2019,4,0,4,1085,220
13829$2019-018-5$US$SCAN$OR$001,2019,4,0,4,1085,224
13829$2019-021-1$US$SCAN$OR$001,2019,4,0,4,1085,228
13829$2019-021-2$US$SCAN$OR$001,2019,4,0,4,1085,232
13829$2019-070-4$US$SCAN$OR$001,2019,4,0,4,1085,236
13829$2019-070-5$US$SCAN$OR$001,2019,4,0,4,1085,240
13829$2019-070-6$US$SCAN$OR$001,2019,4,0,4,1085,244
13829$2019-031-2$US$SCAN$OR$001,2019,5,0,5,1085,249
13829$2019-006-2$US$SCAN$OR$001,2019,6,0,6,1085,255
13829$2019-021-3$US$SCAN$OR$001,2019,6,0,6,1085,261
13829$2019-021-4$US$SCAN$OR$001,2019,6,0,6,1085,267
13829$2019-021-5$US$SCAN$OR$001,2019,6,0,6,1085,273
13829$2019-021-6$US$SCAN$OR$001,2019,6,0,6,1085,279
13829$2019-022-4$US$SCAN$OR$001,2019,6,0,6,1085,285
13829$2019-022-5$US$SCAN$OR$001,2019,6,0,6,1085,291
13829$2019-022-6$US$SCAN$OR$001,2019,6,0,6,1085,297
13829$2019-031-4$US$SCAN$OR$001,2019,6,0,6,1085,303
13829$2019-031-5$US$SCAN$OR$001,2019,6,0,6,1085,309
13829$2019-077-1$US$SCAN$OR$001,2019,6,0,6,1085,315
13829$2019-077-4$US$SCAN$OR$001,2019,6,0,6,1085,321
13829$2019-080-2$US$SCAN$OR$001,2019,6,0,6,1085,327
13829$2019-080-3$US$SCAN$OR$001,2019,6,0,6,1085,333
13829$2019-080-4$US$SCAN$OR$001,2019,6,0,6,1085,339
13829$2019-080-5$US$SCAN$OR$001,2019,6,0,6,1085,345
13829$2019-080-6$US$SCAN$OR$001,2019,6,0,6,1085,351
13829$2019-006-5$US$SCAN$OR$001,2019,7,0,7,1085,358
13829$2019-023-6$US$SCAN$OR$001,2019,7,0,7,1085,365
13829$2019-062-6$US$SCAN$OR$001,2019,7,0,7,1085,372
13829$2019-063-6$US$SCAN$OR$001,2019,7,0,7,1085,379
13829$2019-004-1$US$SCAN$OR$001,2019,8,0,8,1085,387
13829$2019-004-3$US$SCAN$OR$001,2019,8,0,8,1085,395
13829$2019-004-5$US$SCAN$OR$001,2019,8,0,8,1085,403
13829$2019-004-6$US$SCAN$OR$001,2019,8,0,8,1085,411
13829$2019-006-1$US$SCAN$OR$001,2019,8,0,8,1085,419
13829$2019-006-3$US$SCAN$OR$001,2019,8,0,8,1085,427
13829$2019-006-4$US$SCAN$OR$001,2019,8,0,8,1085,435
13829$2019-019-1$US$SCAN$OR$001,2019,8,0,8,1085,443
13829$2019-019-11$US$SCAN$OR$001,2019,8,0,8,1085,451
13829$2019-019-2$US$SCAN$OR$001,2019,8,0,8,1085,459
13829$2019-019-3$US$SCAN$OR$001,2019,8,0,8,1085,467
13829$2019-019-4$US$SCAN$OR$001,2019,8,0,8,1085,475
13829$2019-019-5$US$SCAN$OR$001,2019,8,0,8,1085,483
13829$2019-023-1$US$SCAN$OR$001,2019,8,0,8,1085,491
13829$2019-023-2$US$SCAN$OR$001,2019,8,0,8,1085,499
13829$2019-023-3$US$SCAN$OR$001,2019,8,0,8,1085,507
13829$2019-023-4$US$SCAN$OR$001,2019,8,0,8,1085,515
13829$2019-023-5$US$SCAN$OR$001,2019,8,0,8,1085,523
13829$2019-047-4$US$SCAN$OR$001,2019,8,0,8,1085,531
13829$2019-049-6$US$SCAN$OR$001,2019,8,0,8,1085,539
13829$2019-062-5$US$SCAN$OR$001,2019,8,0,8,1085,547
13829$2019-063-1$US$SCAN$OR$001,2019,8,0,8,1085,555
13829$2019-063-2$US$SCAN$OR$001,2019,8,0,8,1085,563
13829$2019-063-3$US$SCAN$OR$001,2019,8,0,8,1085,571
13829$2019-063-4$US$SCAN$OR$001,2019,8,0,8,1085,579
13829$2019-063-5$US$SCAN$OR$001,2019,8,0,8,1085,587
13829$2019-066-2$US$SCAN$OR$001,2019,8,0,8,1085,595
13829$2019-070-1$US$SCAN$OR$001,2019,8,0,8,1085,603
13829$2019-070-2$US$SCAN$OR$001,2019,8,0,8,1085,611
13829$2019-070-3$US$SCAN$OR$001,2019,8,0,8,1085,619
13829$2019-075-1$US$SCAN$OR$001,2019,8,0,8,1085,627
13829$2019-075-2$US$SCAN$OR$001,2019,8,0,8,1085,635
13829$2019-075-3$US$SCAN$OR$001,2019,8,0,8,1085,643
13829$2019-075-4$US$SCAN$OR$001,2019,8,0,8,1085,651
13829$2019-075-6$US$SCAN$OR$001,2019,8,0,8,1085,659
13829$2019-106-5$US$SCAN$OR$001,2019,8,0,8,1085,667
13829$2019-006-6$US$SCAN$OR$001,2019,9,0,9,1085,676
13829$2019-077-6$US$SCAN$OR$001,2019,9,0,9,1085,685
13829$2019-085-1$US$SCAN$OR$001,2019,9,0,9,1085,694
13829$2019-106-1$US$SCAN$OR$001,2019,9,0,9,1085,703
13829$2019-002-2$US$SCAN$OR$001,2019,0,10,10,1095,703
13829$2019-002-3$US$SCAN$OR$001,2019,0,10,10,1105,703
13829$2019-002-5$US$SCAN$OR$001,2019,0,10,10,1115,703
13829$2019-012-1$US$SCAN$OR$001,2019,10,0,10,1115,713
13829$2019-012-2$US$SCAN$OR$001,2019,10,0,10,1115,723
13829$2019-012-3$US$SCAN$OR$001,2019,10,0,10,1115,733
13829$2019-012-4$US$SCAN$OR$001,2019,10,0,10,1115,743
13829$2019-012-5$US$SCAN$OR$001,2019,10,0,10,1115,753
13829$2019-012-6$US$SCAN$OR$001,2019,10,0,10,1115,763
13829$2019-024-1$US$SCAN$OR$001,2019,10,0,10,1115,773
13829$2019-024-2$US$SCAN$OR$001,2019,10,0,10,1115,783
13829$2019-024-3$US$SCAN$OR$001,2019,10,0,10,1115,793
13829$2019-024-4$US$SCAN$OR$001,2019,10,0,10,1115,803
13829$2019-024-5$US$SCAN$OR$001,2019,10,0,10,1115,813
13829$2019-024-6$US$SCAN$OR$001,2019,10,0,10,1115,823
13829$2019-026-1$US$SCAN$OR$001,2019,10,0,10,1115,833
13829$2019-026-2$US$SCAN$OR$001,2019,10,0,10,1115,843
13829$2019-026-3$US$SCAN$OR$001,2019,10,0,10,1115,853
13829$2019-030-1$US$SCAN$OR$001,2019,10,0,10,1115,863
13829$2019-030-2$US$SCAN$OR$001,2019,10,0,10,1115,873
13829$2019-031-1$US$SCAN$OR$001,2019,10,0,10,1115,883
13829$2019-031-3$US$SCAN$OR$001,2019,10,0,10,1115,893
13829$2019-034-1$US$SCAN$OR$001,2019,10,0,10,1115,903
13829$2019-034-2$US$SCAN$OR$001,2019,10,0,10,1115,913
13829$2019-034-3$US$SCAN$OR$001,2019,10,0,10,1115,923
13829$2019-034-4$US$SCAN$OR$001,2019,10,0,10,1115,933
13829$2019-034-5$US$SCAN$OR$001,2019,10,0,10,1115,943
13829$2019-034-6$US$SCAN$OR$001,2019,10,0,10,1115,953
13829$2019-046-1$US$SCAN$OR$001,2019,10,0,10,1115,963
13829$2019-046-2$US$SCAN$OR$001,2019,10,0,10,1115,973
13829$2019-046-3$US$SCAN$OR$001,2019,10,0,10,1115,983
13829$2019-046-4$US$SCAN$OR$001,2019,10,0,10,1115,993
13829$2019-046-5$US$SCAN$OR$001,2019,10,0,10,1115,1003
13829$2019-046-6$US$SCAN$OR$001,2019,10,0,10,1115,1013
13829$2019-056-1$US$SCAN$OR$001,2019,10,0,10,1115,1023
13829$2019-056-2$US$SCAN$OR$001,2019,10,0,10,1115,1033
13829$2019-056-3$US$SCAN$OR$001,2019,10,0,10,1115,1043
13829$2019-056-4$US$SCAN$OR$001,2019,10,0,10,1115,1053
13829$2019-056-5$US$SCAN$OR$001,2019,10,0,10,1115,1063
13829$2019-056-6$US$SCAN$OR$001,2019,10,0,10,1115,1073
13829$2019-058-1$US$SCAN$OR$001,2019,10,0,10,1115,1083
13829$2019-058-2$US$SCAN$OR$001,2019,10,0,10,1115,1093
13829$2019-058-3$US$SCAN$OR$001,2019,10,0,10,1115,1103
13829$2019-058-4$US$SCAN$OR$001,2019,10,0,10,1115,1113
13829$2019-058-5$US$SCAN$OR$001,2019,10,0,10,1115,1123
13829$2019-058-6$US$SCAN$OR$001,2019,10,0,10,1115,1133
13829$2019-061-001$US$SCAN$OR$001,2019,10,0,10,1115,1143
13829$2019-061-002$US$SCAN$OR$001,2019,10,0,10,1115,1153
13829$2019-061-03$US$SCAN$OR$001,2019,10,0,10,1115,1163
13829$2019-062-1$US$SCAN$OR$001,2019,10,0,10,1115,1173
13829$2019-062-2$US$SCAN$OR$001,2019,10,0,10,1115,1183
13829$2019-062-3$US$SCAN$OR$001,2019,10,0,10,1115,1193
13829$2019-062-4$US$SCAN$OR$001,2019,10,0,10,1115,1203
13829$2019-064-1$US$SCAN$OR$001,2019,10,0,10,1115,1213
13829$2019-064-2$US$SCAN$OR$001,2019,10,0,10,1115,1223
13829$2019-064-3$US$SCAN$OR$001,2019,10,0,10,1115,1233
13829$2019-064-4$US$SCAN$OR$001,2019,10,0,10,1115,1243
13829$2019-064-5$US$SCAN$OR$001,2019,10,0,10,1115,1253
13829$2019-064-6$US$SCAN$OR$001,2019,10,0,10,1115,1263
13829$2019-065-1$US$SCAN$OR$001,2019,10,0,10,1115,1273
13829$2019-065-2$US$SCAN$OR$001,2019,10,0,10,1115,1283
13829$2019-065-3$US$SCAN$OR$001,2019,10,0,10,1115,1293
13829$2019-065-5$US$SCAN$OR$001,2019,10,0,10,1115,1303
13829$2019-065-6$US$SCAN$OR$001,2019,10,0,10,1115,1313
13829$2019-027-3$US$SCAN$OR$001,2019,11,0,11,1115,1324
13829$2019-004-2$US$SCAN$OR$001,2019,12,0,12,1115,1336
13829$2019-013-1$US$SCAN$OR$001,2019,12,0,12,1115,1348
13829$2019-013-2$US$SCAN$OR$001,2019,12,0,12,1115,1360
13829$2019-013-3$US$SCAN$OR$001,2019,12,0,12,1115,1372
13829$2019-013-4$US$SCAN$OR$001,2019,12,0,12,1115,1384
13829$2019-013-5$US$SCAN$OR$001,2019,12,0,12,1115,1396
13829$2019-013-6$US$SCAN$OR$001,2019,12,0,12,1115,1408
13829$2019-014-1$US$SCAN$OR$001,2019,12,0,12,1115,1420
13829$2019-014-2$US$SCAN$OR$001,2019,12,0,12,1115,1432
13829$2019-014-3$US$SCAN$OR$001,2019,12,0,12,1115,1444
13829$2019-014-4$US$SCAN$OR$001,2019,12,0,12,1115,1456
13829$2019-014-5$US$SCAN$OR$001,2019,12,0,12,1115,1468
13829$2019-014-6$US$SCAN$OR$001,2019,12,0,12,1115,1480
13829$2019-026-4$US$SCAN$OR$001,2019,12,0,12,1115,1492
13829$2019-026-5$US$SCAN$OR$001,2019,12,0,12,1115,1504
13829$2019-026-6$US$SCAN$OR$001,2019,12,0,12,1115,1516
13829$2019-027-1$US$SCAN$OR$001,2019,12,0,12,1115,1528
13829$2019-027-2$US$SCAN$OR$001,2019,12,0,12,1115,1540
13829$2019-027-4$US$SCAN$OR$001,2019,12,0,12,1115,1552
13829$2019-027-5$US$SCAN$OR$001,2019,12,0,12,1115,1564
13829$2019-027-6$US$SCAN$OR$001,2019,12,0,12,1115,1576
13829$2019-031-7$US$SCAN$OR$001,2019,12,0,12,1115,1588
13829$2019-055-1$US$SCAN$OR$001,2019,12,0,12,1115,1600
13829$2019-055-2$US$SCAN$OR$001,2019,12,0,12,1115,1612
13829$2019-055-3$US$SCAN$OR$001,2019,12,0,12,1115,1624
13829$2019-055-4$US$SCAN$OR$001,2019,12,0,12,1115,1636
13829$2019-055-5$US$SCAN$OR$001,2019,12,0,12,1115,1648
13829$2019-055-6$US$SCAN$OR$001,2019,12,0,12,1115,1660
13829$2019-061-04$US$SCAN$OR$001,2019,12,0,12,1115,1672
13829$2019-061-05$US$SCAN$OR$001,2019,12,0,12,1115,1684
13829$2019-061-06$US$SCAN$OR$001,2019,12,0,12,1115,1696
13829$2019-066-3$US$SCAN$OR$001,2019,12,0,12,1115,1708
13829$2019-066-4$US$SCAN$OR$001,2019,12,0,12,1115,1720
13829$2019-066-5$US$SCAN$OR$001,2019,12,0,12,1115,1732
13829$2019-071-1$US$SCAN$OR$001,2019,12,0,12,1115,1744
13829$2019-071-2$US$SCAN$OR$001,2019,12,0,12,1115,1756
13829$2019-071-3$US$SCAN$OR$001,2019,12,0,12,1115,1768
13829$2019-071-4$US$SCAN$OR$001,2019,12,0,12,1115,1780
13829$2019-071-5$US$SCAN$OR$001,2019,12,0,12,1115,1792
13829$2019-071-6$US$SCAN$OR$001,2019,12,0,12,1115,1804
13829$2019-075-5$US$SCAN$OR$001,2019,12,0,12,1115,1816
13829$2019-076-4$US$SCAN$OR$001,2019,12,0,12,1115,1828
13829$2019-076-5$US$SCAN$OR$001,2019,12,0,12,1115,1840
13829$2019-076-6$US$SCAN$OR$001,2019,12,0,12,1115,1852
13829$2019-077-3$US$SCAN$OR$001,2019,12,0,12,1115,1864
13829$2019-080-1$US$SCAN$OR$001,2019,12,0,12,1115,1876
13829$2019-106-2$US$SCAN$OR$001,2019,12,0,12,1115,1888
13829$2019-106-3$US$SCAN$OR$001,2019,12,0,12,1115,1900
13829$2019-106-4$US$SCAN$OR$001,2019,12,0,12,1115,1912
13829$2019-002-1$US$SCAN$OR$001,2019,0,14,14,1129,1912
13829$2019-030-5$US$SCAN$OR$001,2019,14,0,14,1129,1926
13829$2019-084-1$US$SCAN$OR$001,2019,14,0,14,1129,1940
13829$2019-084-2$US$SCAN$OR$001,2019,14,0,14,1129,1954
13829$2019-084-3$US$SCAN$OR$001,2019,14,0,14,1129,1968
13829$2019-084-4$US$SCAN$OR$001,2019,14,0,14,1129,1982
13829$2019-084-5$US$SCAN$OR$001,2019,14,0,14,1129,1996
13829$2019-084-6$US$SCAN$OR$001,2019,14,0,14,1129,2010
13829$2019-002-4$US$SCAN$OR$001,2019,0,15,15,1144,2010
13829$2019-017-3$US$SCAN$OR$001,2019,15,0,15,1144,2025
13829$2019-017-4$US$SCAN$OR$001,2019,15,0,15,1144,2040
13829$2019-017-5$US$SCAN$OR$001,2019,15,0,15,1144,2055
13829$2019-017-6$US$SCAN$OR$001,2019,15,0,15,1144,2070
13829$2019-030-3$US$SCAN$OR$001,2019,15,0,15,1144,2085
13829$2019-030-4$US$SCAN$OR$001,2019,15,0,15,1144,2100
13829$2019-030-6$US$SCAN$OR$001,2019,15,0,15,1144,2115
13829$2019-047-3$US$SCAN$OR$001,2019,16,0,16,1144,2131
13829$2019-047-5$US$SCAN$OR$001,2019,16,0,16,1144,2147
13829$2019-047-6$US$SCAN$OR$001,2019,16,0,16,1144,2163
13829$2019-049-1$US$SCAN$OR$001,2019,16,0,16,1144,2179
13829$2019-049-2$US$SCAN$OR$001,2019,16,0,16,1144,2195
13829$2019-049-3$US$SCAN$OR$001,2019,16,0,16,1144,2211
13829$2019-049-4$US$SCAN$OR$001,2019,16,0,16,1144,2227
13829$2019-049-5$US$SCAN$OR$001,2019,16,0,16,1144,2243
13829$2019-066-6$US$SCAN$OR$001,2019,16,0,16,1144,2259
13829$2019-076-1$US$SCAN$OR$001,2019,16,0,16,1144,2275
13829$2019-076-2$US$SCAN$OR$001,2019,16,0,16,1144,2291
13829$2019-076-3$US$SCAN$OR$001,2019,16,0,16,1144,2307
13829$2019-101-1$US$SCAN$OR$001,2019,0,16,16,1160,2307
13829$2019-016-3$US$SCAN$OR$001,2019,18,0,18,1160,2325
13829$2019-101-3$US$SCAN$OR$001,2019,0,18,18,1178,2325
13829$2019-017-1$US$SCAN$OR$001,2019,20,0,20,1178,2345
13829$2019-017-2$US$SCAN$OR$001,2019,20,0,20,1178,2365
13829$2019-035-1$US$SCAN$OR$001,2019,20,0,20,1178,2385
13829$2019-035-2$US$SCAN$OR$001,2019,20,0,20,1178,2405
13829$2019-035-5$US$SCAN$OR$001,2019,20,0,20,1178,2425
13829$2019-035-6$US$SCAN$OR$001,2019,20,0,20,1178,2445
13829$2019-048-2$US$SCAN$OR$001,2019,20,0,20,1178,2465
13829$2019-105-6$US$SCAN$OR$001,2019,20,0,20,1178,2485
13829$2019-035-3$US$SCAN$OR$001,2019,23,0,23,1178,2508
13829$2019-016-1$US$SCAN$OR$001,2019,24,0,24,1178,2532
13829$2019-016-2$US$SCAN$OR$001,2019,24,0,24,1178,2556
13829$2019-016-5$US$SCAN$OR$001,2019,24,0,24,1178,2580
13829$2019-035-4$US$SCAN$OR$001,2019,25,0,25,1178,2605
13829$2019-016-4$US$SCAN$OR$001,2019,26,0,26,1178,2631
13829$2019-016-6$US$SCAN$OR$001,2019,27,0,27,1178,2658
13829$2019-105-4$US$SCAN$OR$001,2019,28,0,28,1178,2686
13829$2019-105-5$US$SCAN$OR$001,2019,28,0,28,1178,2714
13829$2020-008-1$US$SCAN$OR$001,2020,3,0,3,1178,2717
13829$2020-008-10$US$SCAN$OR$001,2020,3,0,3,1178,2720
13829$2020-008-11$US$SCAN$OR$001,2020,3,0,3,1178,2723
13829$2020-008-12$US$SCAN$OR$001,2020,3,0,3,1178,2726
13829$2020-008-13$US$SCAN$OR$001,2020,3,0,3,1178,2729
13829$2020-008-2$US$SCAN$OR$001,2020,3,0,3,1178,2732
13829$2020-008-4$US$SCAN$OR$001,2020,3,0,3,1178,2735
13829$2020-008-5$US$SCAN$OR$001,2020,3,0,3,1178,2738
13829$2020-008-6$US$SCAN$OR$001,2020,3,0,3,1178,2741
13829$2020-008-8$US$SCAN$OR$001,2020,3,0,3,1178,2744
13829$2020-008-9$US$SCAN$OR$001,2020,3,0,3,1178,2747
13829$2020-037-2$US$SCAN$OR$001,2020,3,0,3,1178,2750
13829$2020-008-3$US$SCAN$OR$001,2020,4,0,4,1178,2754
13829$2020-025-3$US$SCAN$OR$001,2020,4,0,4,1178,2758
13829$2020-005-6$US$SCAN$OR$001,2020,5,0,5,1178,2763
13829$2020-036-3$US$SCAN$OR$001,2020,5,0,5,1178,2768
13829$2020-036-6$US$SCAN$OR$001,2020,5,0,5,1178,2773
13829$2020-026-3$US$SCAN$OR$001,2020,6,0,6,1178,2779
13829$2020-026-4$US$SCAN$OR$001,2020,6,0,6,1178,2785
13829$2020-037-1$US$SCAN$OR$001,2020,6,0,6,1178,2791
13829$2020-037-3$US$SCAN$OR$001,2020,6,0,6,1178,2797
13829$2020-037-4$US$SCAN$OR$001,2020,6,0,6,1178,2803
13829$2020-037-5$US$SCAN$OR$001,2020,6,0,6,1178,2809
13829$2020-037-6$US$SCAN$OR$001,2020,6,0,6,1178,2815
13829$2020-013-4$US$SCAN$OR$001,2020,8,0,8,1178,2823
13829$2020-025-1$US$SCAN$OR$001,2020,8,0,8,1178,2831
13829$2020-025-2$US$SCAN$OR$001,2020,8,0,8,1178,2839
13829$2020-025-4$US$SCAN$OR$001,2020,8,0,8,1178,2847
13829$2020-025-6$US$SCAN$OR$001,2020,8,0,8,1178,2855
13829$2020-041-1$US$SCAN$OR$001,2020,8,0,8,1178,2863
13829$2020-041-2$US$SCAN$OR$001,2020,8,0,8,1178,2871
13829$2020-041-3$US$SCAN$OR$001,2020,8,0,8,1178,2879
13829$2020-041-6$US$SCAN$OR$001,2020,8,0,8,1178,2887
13829$2020-049-4$US$SCAN$OR$001,2020,8,0,8,1178,2895
13829$2020-026-5$US$SCAN$OR$001,2020,9,0,9,1178,2904
13829$2020-039-1$US$SCAN$OR$001,2020,9,0,9,1178,2913
13829$2020-005-1$US$SCAN$OR$001,2020,10,0,10,1178,2923
13829$2020-005-2$US$SCAN$OR$001,2020,10,0,10,1178,2933
13829$2020-005-3$US$SCAN$OR$001,2020,10,0,10,1178,2943
13829$2020-005-4$US$SCAN$OR$001,2020,10,0,10,1178,2953
13829$2020-005-5$US$SCAN$OR$001,2020,10,0,10,1178,2963
13829$2020-006-1$US$SCAN$OR$001,2020,10,0,10,1178,2973
13829$2020-006-2$US$SCAN$OR$001,2020,10,0,10,1178,2983
13829$2020-006-3$US$SCAN$OR$001,2020,10,0,10,1178,2993
13829$2020-006-4$US$SCAN$OR$001,2020,10,0,10,1178,3003
13829$2020-006-5$US$SCAN$OR$001,2020,10,0,10,1178,3013
13829$2020-006-6$US$SCAN$OR$001,2020,10,0,10,1178,3023
13829$2020-030-1$US$SCAN$OR$001,2020,10,0,10,1178,3033
13829$2020-030-2$US$SCAN$OR$001,2020,10,0,10,1178,3043
13829$2020-030-3$US$SCAN$OR$001,2020,10,0,10,1178,3053
13829$2020-030-4$US$SCAN$OR$001,2020,10,0,10,1178,3063
13829$2020-030-5$US$SCAN$OR$001,2020,10,0,10,1178,3073
13829$2020-036-1$US$SCAN$OR$001,2020,10,0,10,1178,3083
13829$2020-036-2$US$SCAN$OR$001,2020,10,0,10,1178,3093
13829$2020-036-4$US$SCAN$OR$001,2020,10,0,10,1178,3103
13829$2020-036-5$US$SCAN$OR$001,2020,10,0,10,1178,3113
13829$2020-041-7$US$SCAN$OR$001,2020,10,0,10,1178,3123
13829$2020-041-8$US$SCAN$OR$001,2020,10,0,10,1178,3133
13829$2020-007-1$US$SCAN$OR$001,2020,12,0,12,1178,3145
13829$2020-007-2$US$SCAN$OR$001,2020,12,0,12,1178,3157
13829$2020-007-3$US$SCAN$OR$001,2020,12,0,12,1178,3169
13829$2020-007-4$US$SCAN$OR$001,2020,12,0,12,1178,3181
13829$2020-007-5$US$SCAN$OR$001,2020,12,0,12,1178,3193
13829$2020-007-6$US$SCAN$OR$001,2020,12,0,12,1178,3205
13829$2020-027-1$US$SCAN$OR$001,2020,12,0,12,1178,3217
13829$2020-027-13$US$SCAN$OR$001,2020,12,0,12,1178,3229
13829$2020-027-14$US$SCAN$OR$001,2020,12,0,12,1178,3241
13829$2020-027-15$US$SCAN$OR$001 -001,2020,12,0,12,1178,3253
13829$2020-027-2$US$SCAN$OR$001,2020,12,0,12,1178,3265
13829$2020-027-3$US$SCAN$OR$001,2020,12,0,12,1178,3277
13829$2020-027-4$US$SCAN$OR$001,2020,12,0,12,1178,3289
13829$2020-031-1$US$SCAN$OR$001,2020,12,0,12,1178,3301
13829$2020-031-2$US$SCAN$OR$001,2020,12,0,12,1178,3313
13829$2020-031-3$US$SCAN$OR$001,2020,12,0,12,1178,3325
13829$2020-031-4$US$SCAN$OR$001,2020,12,0,12,1178,3337
13829$2020-031-5$US$SCAN$OR$001,2020,12,0,12,1178,3349
13829$2020-031-6$US$SCAN$OR$001,2020,12,0,12,1178,3361
13829$2020-039-2$US$SCAN$OR$001,2020,12,0,12,1178,3373
13829$2020-039-5$US$SCAN$OR$001,2020,12,0,12,1178,3385
13829$2020-039-6$US$SCAN$OR$001,2020,12,0,12,1178,3397
13829$2020-043-1$US$SCAN$OR$001,2020,12,0,12,1178,3409
13829$2020-043-2$US$SCAN$OR$001,2020,12,0,12,1178,3421
13829$2020-043-3$US$SCAN$OR$001,2020,12,0,12,1178,3433
13829$2020-043-4$US$SCAN$OR$001,2020,12,0,12,1178,3445
13829$2020-043-5$US$SCAN$OR$001,2020,12,0,12,1178,3457
13829$2020-013-6$US$SCAN$OR$001,2020,14,0,14,1178,3471
13829$2020-020-1$US$SCAN$OR$001,2020,15,0,15,1178,3486
13829$2020-020-2$US$SCAN$OR$001,2020,15,0,15,1178,3501
13829$2020-020-3$US$SCAN$OR$001,2020,15,0,15,1178,3516
13829$2020-039-3$US$SCAN$OR$001,2020,15,0,15,1178,3531
13829$2020-039-4$US$SCAN$OR$001,2020,15,0,15,1178,3546
13829$2020-013-1$US$SCAN$OR$001,2020,16,0,16,1178,3562
13829$2020-013-2$US$SCAN$OR$001,2020,16,0,16,1178,3578
13829$2020-013-3$US$SCAN$OR$001,2020,16,0,16,1178,3594
13829$2020-013-5$US$SCAN$OR$001,2020,16,0,16,1178,3610
13829$2020-044-2$US$SCAN$OR$001,2020,16,0,16,1178,3626
